###############
#    @@@   @@ #
# #@# # # # # #
# @ @@    @@@ #
# # # #@# # # #
#   @  @      #
#@#@# # # # # #
#    @@@@@@@  #
# # # # # # # #
#@@@     @@@ @#
# # # # # # # #
#  @@@@   @@ @#
# # # # # # #@#
#@@@@@    @@  #
###############