######
#    #
#  SS#
#    #
#    #
#   E#
######