###############
#          @@A#
# #@# # # # # # 
#   @@ A  @@@ #
# # # #@# # # #
#   @  @      #
#@#@# # # # #A#
#    @@@@@@@  #
# # # # # # # #
#@@@     @@@ @#
# # # # # # # #
#  @@@@A  @@ @#
# # # # # # #@#
#@@@@@    @@  #
###############