###############
#    @@@   @@ #
# #@# # # # # #
# @ @@ A  @@@ #
# # # #@# # # #
#   @  @      #
#@#@# # # # #A#
#    @@@@@@@  #
# # # # # # # #
#@@@     @@@ @#
# # # # # # # #
#  @@@@A  @@ @#
# # # # # # #@#
#@@@@@    @@  #
###############