###############
#PSSSSSSSSSSSS#
#   G G       #
# AAAAAAAAAAAA#
#             #
# NNNNNNNNNNNN#
#            B#
#ELLLLLLLLLLLL#
#@@@@@@@@@@@@@#
#@@@@@@@@@@@@@#
#@@@@@@@@@@@@@#
#@@@@@@@@@@@@@#
#@@@@@@@@@@@@@#
#@@@@@@@@@@@@E#
###############