###############
#             #
#          P  #
# NNN         #
#             #
#    AAA      #
#             #
#   SSS   E   #
#             #
#      LLL    #
#             #
#@@@      @@@@#
#@@@@     @@@@#
#H@@@     @@@B#
###############