###############
#          @LB#
# #@# # # # # #
#   N@ B  @N@ #
# # # #@# # # #
#   @  @   H  #
#A#@# # # # #B#
#  H @@@S@@@  #
# # # # # # # #
#@@@     @@@ @#
# # # # # # # #
# H@N@@B  @A @#
# # # # # # #@#
#@A@E@   B@@  #
###############