######
#    #
#  SS#
#    #
#    #
#   X#
######