###############
#PSSSSSSSSSSSS#
#             #
# AAAAAAAAAAAA#
#             #
# NNNNNNNNNNNN#
#             #
# LLLLLLLLLLLL#
#@@@@@@@@@@@@@#
#@@@@@@@@@@@@@#
#@@@@@@@@@@@@@#
#@@@@@@@@@@@@@#
#@@@@@@@@@@@@@#
#@@@@@@@@@@@@E#
###############