###############
#             #
#             #
#             #
#             #
#             #
#             #
#             #
#             #
#             #
#             #
#@@@@     @@@@#
#@@@@     @@@@#
#B@@@     @@@A#
###############