###############
#    @@@   @@ #
# #@# # # # # #
#@@ @@    @@@ #
# # # #@# # # #
#  @@  @      #
#@#@# # # # # #
#    @@@@@@@  #
# # # # # # # #
#@@@     @@@ @#
# # # # # # # #
#  @@@@   @@ @#
# # # # # # #@#
#@@@@@    @@  #
###############