###############
#             #
#          P  #
#             #
#             #
#             #
#             #
#         X   #
#             #
#             #
#             #
#@@@      @@@@#
#@@@@     @@@@#
#B@@@     @@@A#
###############