###############
#             #
#          P  #
# OOO         #
#             #
#    RRR      #
#             #
#   SSS   X   #
#             #
#      LLL    #
#             #
#@@@      @@@@#
#@@@@     @@@@#
#B@@@     @@@A#
###############