###############
#          @@B#
# #@# # # # # #
#   @@ B  @@@ #
# # # #@# # # #
#   @  @   H  #
#@#@# # # # #B#
#  H @@@@@@@  #
# # # # # # # #
#@@@     @@@ @#
# # # # # # # #
# H@@@@B  @@ @#
# # # # # # #@#
#@@@@@   B@@  #
###############