#############
#P          #
#  #@@#@@#  #
#  @     @  #
#  #A # A#B #
#  @  @  @  #
#  # A#A #  #
#  @  @  @  #
# B#A # A#  #
#  @  @  @  #
#  # A#A # B#
#  @  @  @  #
#@@#@@#@@#@@#
#@@@@@@@@@@@#
#############