#############
#P          #
#  #@@#@@#  #
#  @     @  #
#  #B # B#H #
#  @  @  @  #
#  # B#B #  #
#  @  @  @  #
# H#B # B#  #
#  @  @  @  #
#  # B#B # H#
#  @  @  @  #
#@@#@@#@@#@@#
#@@@@@@@@@@@#
#############