#############
#P          #
#  #SS#SS#  #
#  N     N  #
#  #B # B#H #
#  N  @  N  #
#  # B#B #  #
#  A  @  A  #
# H#B # B#  #
#  A  @  A  #
#  # B#B # H#
#  @  @  @  #
#@@#@@#@@#@@#
#@@@@@@@@@@@#
#############